5479543,6505803,10127622,10302451,176870,11503417,5330286,11476171,3081361,644241,24180719,6918837,11656518,60700,36314,11626560,10461815,9826528,216345,16038120,216239,135398510,208908,60838
1,1,1,1,1,1,1,1,1,1,1,1,1,0,1,0,1,1,1,1,1,1,1,1
1,0,1,0,0,1,0,1,0,1,0,0,1,1,1,1,1,1,1,1,1,1,1,1
1,1,0,1,0,1,0,1,0,0,0,0,1,1,1,1,0,0,1,0,1,0,0,1
1,0,0,0,0,0,0,1,0,1,0,1,0,1,1,1,0,1,0,0,0,0,0,1
0,1,1,1,1,1,1,1,1,0,1,1,1,0,1,0,1,1,0,1,0,0,1,1
1,0,1,1,1,1,0,1,1,0,0,1,0,1,1,1,1,0,0,0,1,0,1,1
0,0,1,1,1,1,0,0,0,1,0,1,0,1,0,0,1,0,0,0,1,0,1,0
0,1,1,1,0,0,1,0,0,0,1,1,0,1,1,0,0,1,1,0,0,0,0,1
1,1,1,1,0,1,1,1,1,1,1,0,1,1,1,1,1,1,1,1,1,1,1,1
0,1,0,1,1,1,1,0,1,1,1,0,1,1,1,0,0,0,1,1,1,1,1,1
1,1,1,1,1,1,1,0,1,1,1,1,1,1,1,0,1,1,1,1,1,1,1,1
0,1,0,1,0,0,1,0,1,0,0,1,1,1,1,0,1,1,1,0,1,1,1,0
1,1,1,1,1,1,1,1,1,0,0,0,0,1,1,0,1,1,0,0,0,0,0,1
0,1,1,1,1,0,1,0,1,0,1,1,0,1,0,1,0,0,1,0,0,0,1,1
0,0,0,1,1,0,1,1,0,1,0,0,1,0,1,0,1,1,1,1,1,1,1,1
1,1,0,1,1,0,0,1,1,1,0,0,1,0,0,1,1,0,0,1,0,1,1,1
1,1,1,1,1,1,0,1,1,1,1,1,0,1,1,1,1,1,0,0,0,0,1,1
1,1,1,1,1,1,1,1,1,1,1,1,1,1,1,1,1,1,1,1,1,1,1,1
0,0,0,1,1,0,1,1,1,1,0,0,0,1,0,0,0,0,1,0,0,0,1,0
1,1,1,1,1,0,0,1,0,1,1,1,1,0,1,1,1,1,1,1,1,1,1,0
0,1,0,1,0,0,1,0,1,1,0,0,1,1,1,0,0,0,0,1,0,1,1,0
1,0,0,1,1,1,0,0,0,0,0,0,0,0,1,0,0,1,0,0,0,0,0,0
1,1,1,1,1,1,1,1,1,1,1,1,1,1,1,1,1,1,1,1,1,1,1,1
0,1,0,1,1,1,1,0,1,0,1,0,0,0,0,0,1,0,0,1,1,1,1,0
0,0,1,1,0,0,0,0,1,1,1,0,0,1,1,1,1,1,1,0,1,0,1,1
1,1,1,0,0,1,0,0,0,0,1,1,0,0,0,1,1,0,1,1,1,0,0,1
1,1,0,1,1,1,1,1,1,1,1,1,1,1,1,1,1,0,1,0,1,1,1,1
1,0,0,0,0,1,0,0,1,1,0,1,0,0,1,1,0,1,1,1,0,0,1,0
0,1,0,0,0,0,1,0,0,0,0,1,0,1,1,1,0,0,0,0,0,1,0,1
0,1,0,0,1,1,1,1,1,0,0,1,1,1,1,1,1,0,0,0,0,0,0,1
1,1,1,1,0,1,1,1,1,1,1,0,0,1,1,1,1,1,1,1,0,1,1,1
0,1,1,0,0,0,0,0,1,0,1,1,0,0,0,0,0,0,1,0,0,1,1,0
1,0,0,0,0,0,1,1,1,1,0,0,0,0,1,1,1,0,1,1,0,0,0,0
1,1,1,1,1,1,1,0,1,1,1,1,1,1,1,1,1,0,1,1,1,1,1,1
0,1,0,0,1,1,0,0,0,0,1,0,0,0,1,1,0,1,0,0,1,0,1,0
1,1,0,0,0,1,1,1,0,0,0,1,0,0,1,0,0,1,1,1,1,1,0,0
1,1,1,1,1,1,1,1,1,1,1,1,1,1,1,1,1,1,1,1,1,1,1,1
0,0,1,1,0,1,1,0,0,1,1,1,1,0,0,0,1,1,0,0,0,0,0,0
1,1,1,0,1,1,1,1,0,1,1,0,0,1,1,0,0,1,0,0,1,0,1,1
1,1,1,1,1,1,1,1,1,1,1,1,1,1,1,1,1,1,1,1,1,1,0,1
1,1,1,1,0,0,0,1,0,0,0,1,1,0,1,0,0,1,1,0,1,0,0,0
0,1,0,1,1,0,1,1,1,1,1,1,1,1,1,1,0,0,1,1,1,1,1,1
1,1,0,0,0,1,0,1,0,0,1,0,1,0,1,0,0,0,1,0,1,0,1,0
1,1,1,1,1,0,1,1,1,1,1,0,1,1,0,1,1,1,1,1,1,1,1,1
0,1,1,1,1,1,1,1,1,1,1,1,1,0,0,1,1,0,0,1,1,1,1,0
0,1,1,1,1,1,1,1,1,1,0,0,1,0,1,1,1,0,1,1,1,0,1,1
1,1,1,1,1,0,1,0,0,1,0,1,0,0,0,1,1,0,1,1,1,1,1,1
1,0,0,0,0,1,1,1,0,1,0,1,1,1,1,0,0,1,0,1,0,1,0,1
1,1,1,0,1,1,0,0,1,0,1,0,0,0,0,1,1,1,1,1,0,1,0,0
0,0,1,1,0,0,1,1,1,0,1,1,0,1,0,1,1,0,1,1,1,1,1,1
1,0,0,1,1,1,0,1,1,1,0,1,1,1,1,1,1,1,1,1,1,0,1,1
0,0,0,0,1,1,0,1,0,0,0,0,0,1,1,1,0,1,0,0,0,0,0,1
0,1,0,1,0,0,1,0,1,1,0,1,1,1,1,0,1,0,1,0,0,1,1,1
1,1,0,0,0,1,1,0,0,1,0,0,0,0,1,0,0,0,0,0,1,1,1,0
0,1,0,1,0,0,1,1,0,0,1,1,0,0,1,1,1,1,1,1,0,0,1,1
1,1,1,1,1,0,0,1,1,0,1,1,1,1,1,1,1,1,1,1,1,1,1,1
1,0,1,1,1,0,1,0,0,0,0,0,1,1,1,0,0,0,1,1,1,0,1,1
0,1,1,1,0,1,1,1,1,0,0,0,1,1,1,0,1,1,0,1,0,1,1,1
0,1,1,1,1,1,1,1,1,1,1,1,1,1,1,1,1,1,1,1,1,1,1,1
0,1,1,1,0,1,1,1,1,1,1,0,0,1,1,1,1,1,1,1,1,1,1,1
1,1,1,0,0,0,1,0,0,0,0,0,0,1,1,0,1,0,1,0,0,0,0,1
1,1,1,1,1,1,1,0,0,1,1,1,0,0,1,1,1,1,1,0,1,0,0,1
0,0,1,0,0,0,1,0,1,1,0,1,1,0,0,1,1,0,1,1,0,1,0,1
0,0,1,1,1,1,1,1,0,1,1,1,1,1,1,1,1,1,1,1,1,1,1,1
